R  800  600
NO ./texture/bluestone.xpm
SO ./texture/colorstone.xpm
WE ./texture/purplestone.xpm
EA ./texture/greystone.xpm
S ./texture/pillar.xpm
F 220,100,0
C 225,30,0

0000000000000000000000000000000000011111111111
11111111111111111111111111111111111100000000001
1000000000000000000000000000001000000000000000111111111111111111111111111111111
1000000000000000000000S000000010000000000000000000000000000000000000000000001
10000000000000000000000000000000000000222220000000000000000000001000000000001
1111111111111111111111111111111111110200000200111111111111111111100000111111111
11111111111111111111111111111111111102000002001                 1000001
1000000000000000000000000000000000000200000201                  1000001
1000000000000000000000000000000000000200000201                  1000001
11111111111111111111111111111111111102000002001                 1000001
1000000000000000000000000000001000000200000200111111111111111111100000111111111
10000000000000000000000000000010000002000002000000000000000000000000000000001
10000000000000000000000000000000000000222220000000000000000000001000000000001
1111111111111111111111111111111111110000000000111111111111111111111111111111111
11111111111111111111111111111111111100000000001
0000000000000000000000000000000000011111111111
