R  1080  720
NO ./texture/bluestone.xpm
SO ./texture/colorstone.xpm
WE ./texture/purplestone.xpm
EA ./texture/greystone.xpm
S ./texture/pillar.xpm
F 220,100,0
C 225,30,0

1111111111111111
1000000000000001
1000000000000001
1000000000000001
1111111111111111
