R  800  600
NO ./texture/bluestone.xpm
SO ./texture/colorstone.xpm
WE ./texture/purplestone.xpm
EA ./texture/greystone.xpm
S ./texture/pillar.xpm
F 220,100,0
C 225,30,0

11111111111111111
10002000000000001
10000000000000001
10000000000000021
11111111111111111
