R  1080  700
NO ./texture/bluestone.xpm
SO ./texture/colorstone.xpm
WE ./texture/purplestone.xpm
EA ./texture/greystone.xpm
S ./texture/pillar.xpm
F 100,100,0
C 105,30,0

11111111111111111111111111111111111111111111111
11111111111111111111111111111111111100000000001
1000000000000000000000000000001000000000000000111111111111111111111111111111111
10000000000000000000000000000010000000000000000000000000000000000000000000001
10000000000000000000000000000000000000222220000000000000000000001000000000001
1111111111111111111111111111111111110200000200111111111111111111100000111111111
11111111111111111111111111111111111102000002001                 1000001
1000000000000000000000000000000000000200000201                  1000001
1000000000000000000000000000000000000200000201                  1000001
11111111111111111111111111111111111102000002001                 1000001
1000000000000000000000000000001000000200000200111111111111111111100000111111111
10000000000000000000000000000010000002000002000000000000000000000000000000001
10000000000000000000000000000000000000222220000000000000000000001000000000001
1111111111111111111111111111111111110000000000111111111111111111111111111111111
11111111111111111111111111111111111100000000001
                                   100000000001
                                   100000000001
11111111111111111111111111111111111100000000001
1000000000000000000000000000001000000000000000111111111111111111111111111111111
10000000000000000000000000000010000000000000000000000000000000000000000000001
10000000000000000000000000000000000000222220000000000000000000001000000000001
1111111111111111111111111111111111110200000200111111111111111111100000111111111
11111111111111111111111111111111111102000002001                 1000001
1000000000000000000000000000000000000200000201                  1000001
1000000000000000000000000000000000000200N00201                  1000001
11111111111111111111111111111111111102000002001                 1000001
1000000000000000000000000000001000000200000200111111111111111111100000111111111
10000000000000000000000000000010000002000002000000000000000000000000000000001
10000000000000000000000000000000000000222220000000000000000000001000000000001
1111111111111111111111111111111111110000000000111111111111111111111111111111111
11111111111111111111111111111111111100000000001
11111111111111111111111111111111111111111111111
