11111111
1NNNNNN1
11111111

111
1N1
111

1111
10N1
1111

11111111
10200N11
11111111

11111111111111111111111111111111111111111111111
11111111111111111111111111111111111100000000001
1000000000000000000000000000001000000000000000111111111111111111111111111111111
10000000000000000000000000000010000000000000000000000000000000000000000000001
10000000000000000000000000000000000000000000000000000000000000001000000000001
1111111111111111111111111111111111110000000000111111111111111111100000111111111
11111111111111111111111111111111111100000000001                 1000001
1000000000000000000000000000000000000000000001                  1000001
1000000000000000000000000000000000000000000001                  1000001
11111111111111111111111111111111111100000000001                 1000001
1000000000000000000000000000001000000000000000111111111111111111100000111111111
10000000000000000000000000000010000000000000000000000000000000000000000000001
10000000000000000000000000000000000000000000000000000000000000001000000000001
1111111111111111111111111111111111110000000000111111111111111111111111111111111
11111111111111111111111111111111111100000000001
                                   100000000001
                                   100000000001
11111111111111111111111111111111111100000000001
1000000000000000000000000000001000000000000000111111111111111111111111111111111
10000000000000000000000000000010000000000000000000000000000000000000000000001
10000000000000000000000000000000000000000000000000000000000000001000000000001
1111111111111111111111111111111111110000000000111111111111111111100000111111111
11111111111111111111111111111111111100000000001                 1000001
1000000000000000000000000000000000000000000001                  1000001
10000000000000000000000000000000000000000N0001                  1000001
11111111111111111111111111111111111100000000001                 1000001
1000000000000000000000000000001000000000000000111111111111111111100000111111111
10000000000000000000000000000010000000000000000000000000000000000000000000001
10000000000000000000000000000000000000000000000000000000000000001000000000001
1111111111111111111111111111111111110000000000111111111111111111111111111111111
11111111111111111111111111111111111100000000001
11111111111111111111111111111111111111111111111

11111111111111111111111111111111111111111111111
11111111111111111111111111111111111100000000001
1000000000000000000000000000001000000000000000111111111111111111111111111111111
10000000000000000000000000000010000000000000000000000000000000000000000000001
10000000000000000000000000000000000000000000000000000000000000001000000000001
1111111111111111111111111111111111110000000000111111111111111111100000111111111
11111111111111111111111111111111111100000000001                 1000001
1000000000000000000000000000000000000000000001                  1000001
1000000000000000000000000000000000000000000001                  1000000
11111111111111111111111111111111111100000000001                 1000001
1000000000000000000000000000001000000000000000111111111111111111100000111111111
10000000000000000000000000000010000000000000000000000000000000000000000000001
10000000000000000000000000000000000000000000000000000000000000001000000000001
1111111111111111111111111111111111110000000000111111111111111111111111111111111
11111111111111111111111111111111111100000000001
                                   100000000001
                                   100000000001
11111111111111111111111111111111111100000000001
1000000000000000000000000000001000000000000000111111111111111111111111111111111
10000000000000000000000000000010000000000000000000000000000000000000000000001
10000000000000000000000000000000000000000000000000000000000000001000000000001
1111111111111111111111111111111111110000000000111111111111111111100000111111111
11111111111111111111111111111111111100000000001                 1000001
1000000000000000000000000000000000000000000001                  1000001
10000000000000000000000000000000000000000N0001                  1000001
11111111111111111111111111111111111100000000001                 1000001
1000000000000000000000000000001000000000000000111111111111111111100000111111111
10000000000000000000000000000010000000000000000000000000000000000000000000001
10000000000000000000000000000000000000000000000000000000000000001000000000001
1111111111111111111111111111111111110000000000111111111111111111111111111111111
11111111111111111111111111111111111100000000001
11111111111111111111111111111111111111111111111